1111111111111111111111111111111111
1E000M000M00000C000MC0M00000000011
1010010100100M001010M1M00M00010101
1010010010101010001001000000010101
1P0000000CM0C0M0000000M00000000MC1
1111111111111111111111111111111111