1111111111111111111111
1001000000011000000001
1M0000000M000000000001
1CM000000M0000CE00P001
1M00M010000C0000000001
1MM0000000C00000000C01
1000000100100C01000001
1111111111111111111111
